{
    "corridor-walls": [ 12, 18, 24 ],
    "wall-doors": [
        [ 2, 24 ],
        [ 4, 40 ],
        [ 28, 28 ]
    ],
    "key-rooms": [
        [ 13, 3 ],
        [ 7, 19 ],
        [ 15, 15 ]
    ],
    "-": [
        "#################",
        "#               #",
        "# #####/####### #",
        "# #        k  #k#",
        "# # ###/##### # #",
        "# / #    k  # # #",
        "# # # ##### # # #",
        "# # / / # / # # #",
        "# # # ##### # # #",
        "# # #  k#   # # #",
        "# # ######### # #",
        "# #        k# # #",
        "# ###############",
        "#               /",
        "#################"
    ]
}