+-----------------+
|x               k|
| +-/--+ +-----+ |
| |    | |     | |
| | ++ | | +-+ | |
| | || | | | | | |
| | ++-/ | +-+ | |
| |      |  k  | |
| +------+-----+ |
|                |
| +------------+ |
| |          k | |
| | +------/--+ |
| | |          | |
| | | +------+ | |
| | | |      | | |
| | +-/  +-+ | | |
| |         | | | |
| +---------+ | | |
|          k  | | |
+-------------+-+-+