+---------+
|x       k|
| +--/--+ |
| |     | |
| | +-+ | |
| | | | | |
| | +-+ | |
| |     | |
| +-----+ |
|         |
+---------+